2 2 2 2 2 2 2 2 2 2 2 2 2 2 2 2 2 2 2 2 2 2 2 2 2 2 2 2 2 2 2 2 2 2 2 2 2 2 2 2 2 2 2 2 2 2 2 2 2 2 
2 2 2 2 2 2 2 2 2 3 3 3 3 2 2 2 2 2 2 2 2 2 2 2 2 2 2 2 2 2 2 2 2 2 2 2 2 2 2 2 2 2 2 2 2 2 2 2 2 2 
2 2 2 2 3 3 3 3 3 14 15 15 15 15 15 15 14 3 3 2 2 2 2 2 2 2 2 2 2 2 2 2 2 0 0 0 0 0 0 0 0 0 0 0 0 0 0 0 2 2 
2 2 2 3 3 14 15 15 15 14 3 3 3 3 3 3 14 15 15 3 2 2 2 2 2 2 2 2 2 2 2 2 2 0 0 0 0 0 0 0 0 0 0 0 0 0 0 2 2 2 
2 2 2 15 15 14 3 3 3 3 3 3 29 3 3 3 3 3 14 3 3 2 2 2 2 2 2 2 2 2 2 2 0 0 0 0 0 0 0 0 0 0 0 0 0 0 0 0 0 0
2 2 2 14 3 3 3 29 3 3 3 3 3 21 22 3 3 3 14 3 3 3 2 2 2 2 2 2 2 2 2 2 0 0 0 0 0 0 0 0 0 0 4 0 0 0 0 0 0 0 
2 2 2 14 3 29 3 3 3 17 18 3 3 23 24 3 3 3 14 3 3 3 2 2 2 2 2 2 2 2 2 2 0 0 0 0 0 0 0 0 0 4 4 4 0 0 0 0 0 0  
2 2 3 14 3 3 3 3 3 19 20 3 29 3 3 3 29 3 14 3 3 3 2 2 2 2 2 2 2 2 2 2 0 0 0 0 0 0 4 4 4 4 4 4 0 0 0 0 0 0  
2 2 3 14 3 3 29 3 3 5 3 3 3 3 3 3 14 15 14 3 3 3 3 3 2 2 2 2 2 2 2 2 2 0 0 0 0 0 0 4 4 4 4 4 4 4 4 4 4 0    
2 2 3 14 3 3 3 3 3 29 5 3 29 3 3 3 14 3 3 3 4 3 3 2 2 2 2 2 2 2 2 0 0 0 0 0 4 4 4 4 4 4 4 4 4 4 4 4 4 4
2 2 3 14 3 3 3 3 3 5 5 5 5 3 3 3 14 3 3 3 4 4 4 3 2 2 2 2 2 2 2 2 0 0 0 0 0 4 4 4 4 4 4 4 4 4 4 4 4 4 
2 2 3 15 15 15 15 15 15 16 5 5 16 15 15 15 15 3 4 4 4 4 4 3 2 2 2 2 2 2 2 2 0 0 0 0 0 4 4 4 4 4 4 4 4 4 4 4 4 4 
2 2 3 3 3 3 3 3 3 5 5 5 3 3 3 3 4 4 4 4 4 4 4 3 2 2 2 2 2 2 2 2 0 0 0 0 4 4 4 4 4 4 4 4 4 4 4 4 4 4 
2 2 3 3 3 3 3 5 5 5 5 5 5 5 5 5 4 4 4 4 4 4 4 4 4 3 3 3 3 3 3 3 3 3 0 4 4 4 4 4 4 4 4 4 4 4 4 4 4 4  
2 2 3 3 3 3 3 5 5 5 5 5 5 5 5 5 4 4 4 4 4 3 3 3 3 3 3 3 3 3 3 3 3 4 4 4 4 4 4 4 4 4 4 4 4 4 4 4 4 4   
2 2 4 3 3 3 3 5 5 5 5 5 5 5 5 5 4 4 4 4 4 4 3 3 3 3 3 3 3 3 4 4 4 4 4 4 4 4 4 4 4 4 0 0 0 4 4 4 4 4 
2 2 4 4 4 3 5 5 5 5 5 5 5 5 5 5 4 4 4 4 4 4 4 4 4 4 4 4 4 4 4 4 4 4 4 4 4 4 4 0 0 0 0 27 0 0 4 4 4 4  
2 2 4 4 4 4 4 4 5 5 4 5 5 5 5 5 4 4 4 4 4 4 4 4 4 4 4 4 4 4 4 4 4 4 4 4 4 0 0 0 0 0 0 0 0 0 0 4 4 4   
2 2 4 4 4 4 4 4 4 4 4 4 5 5 5 5 4 4 4 4 4 4 4 4 4 4 4 4 4 4 4 4 4 4 4 4 0 0 0 0 0 0 27 0 0 0 0 4 4 4   
2 2 4 4 4 4 4 4 4 4 5 5 5 5 5 5 5 4 4 4 4 4 4 4 4 4 4 4 4 4 4 4 4 4 0 0 4 4 0 0 0 0 0 0 0 0 0 0 0 4
2 2 4 4 4 4 4 4 4 5 5 5 5 3 5 5 5 5 5 3 3 4 4 4 4 4 4 4 4 4 4 4 4 4 0 0 0 4 4 0 0 0 0 0 0 0 0 0 0 0
2 2 2 4 4 4 4 4 4 4 4 4 5 4 3 5 5 5 5 3 3 3 3 3 4 4 4 4 4 4 4 3 3 3 0 0 0 0 0 0 0 0 0 27 0 0 26 0 0 0 
2 2 2 4 4 4 4 4 4 4 4 4 4 4 3 5 5 5 5 5 3 3 3 3 3 3 3 4 4 4 3 3 3 3 0 0 0 0 4 0 0 0 0 0 0 0 0 0 0 0 
2 2 2 4 4 4 4 4 4 4 4 4 4 5 5 5 4 3 4 5 5 5 3 3 3 3 3 3 3 3 3 3 3 3 3 3 0 4 4 0 0 0 0 0 0 0 0 0 0 0 
2 2 2 3 5 4 4 4 4 4 4 4 5 5 5 4 4 4 4 5 5 5 3 3 3 3 3 3 3 3 3 3 3 3 3 4 0 0 4 4 4 3 3 0 0 0 26 4 4 0 
2 2 2 3 5 5 4 4 4 4 4 4 5 5 5 4 4 4 4 4 3 3 3 3 3 3 3 3 3 3 3 3 3 3 4 4 0 0 4 4 4 3 3 3 4 4 0 4 0 0 
2 2 2 3 5 5 3 4 4 4 4 5 5 5 4 4 4 4 4 4 4 4 3 3 3 3 3 3 3 3 3 3 3 3 4 4 4 4 4 4 4 3 3 3 0 0 4 0 27 0 
2 2 2 3 5 5 3 3 3 4 5 5 5 4 4 4 4 4 4 4 4 4 3 3 3 3 3 3 3 3 3 3 3 3 4 4 4 4 4 4 4 5 5 3 3 4 0 0 0 0 
2 2 3 3 5 27 5 5 5 5 5 5 5 5 4 4 4 4 4 4 4 4 4 3 3 3 3 3 3 3 3 3 5 5 4 4 4 5 5 5 5 5 5 4 4 4 0 0 0 0  
2 2 3 3 5 5 5 3 26 3 5 5 5 5 4 4 4 4 4 4 4 4 4 3 3 3 3 3 3 3 3 3 3 5 5 5 5 5 5 5 5 5 5 4 4 4 0 0 0 0 
2 2 3 3 3 27 3 3 3 3 5 5 5 5 4 4 4 4 4 4 4 4 4 4 3 3 3 3 3 3 3 4 5 5 5 5 5 5 5 5 5 5 4 4 4 4 0 0 0 0  
2 2 3 26 3 3 3 3 3 3 5 5 5 4 4 4 4 4 4 4 4 4 4 4 4 4 4 4 4 4 4 4 4 5 5 5 5 5 5 5 5 4 4 4 4 0 0 0 0 0
2 2 3 3 3 3 3 3 3 3 5 5 5 4 4 4 4 4 4 4 4 4 4 4 4 4 0 0 0 0 4 4 4 5 5 5 5 5 5 5 5 4 4 4 4 0 0 0 0 0
2 2 3 3 3 27 3 27 3 3 3 3 3 3 4 4 4 4 4 4 4 4 4 4 4 4 4 0 0 26 0 4 4 5 5 5 5 5 5 5 5 3 4 4 4 0 0 0 0 0
2 2 3 3 3 3 3 3 3 3 3 3 27 3 4 4 4 4 4 4 4 4 4 4 4 4 4 4 0 0 0 4 4 5 5 5 5 5 5 5 3 3 3 3 4 0 0 0 0 0
2 2 3 3 3 27 3 3 3 27 3 3 3 3 3 4 4 4 4 4 4 4 4 4 4 4 4 4 0 0 0 3 3 5 5 5 5 5 5 5 3 4 3 3 0 0 27 0 0 0 
2 2 3 3 3 3 3 3 26 3 3 3 3 3 3 4 4 4 4 4 4 4 4 4 4 4 4 4 0 0 4 3 3 5 5 5 5 5 5 5 4 4 3 3 0 0 0 0 2 2  
2 2 3 3 3 27 3 3 3 3 3 3 3 3 3 4 4 4 4 4 4 4 4 4 4 4 4 0 0 0 4 3 3 5 5 5 5 5 5 5 4 0 0 0 0 0 0 2 2 2 
2 2 3 26 3 3 3 3 3 27 3 3 3 3 3 4 4 4 4 4 0 4 4 4 4 4 4 0 0 4 4 3 3 5 5 5 5 5 5 4 4 0 26 0 0 0 2 2 2 2 
2 2 3 3 3 3 3 3 3 3 3 3 3 2 2 2 2 4 4 4 0 4 4 4 4 4 4 4 4 4 4 4 3 3 3 3 3 3 3 4 4 0 0 0 0 2 2 2 2 2 
2 2 3 3 3 3 3 3 3 3 3 2 2 2 2 2 2 0 0 0 0 4 4 4 4 4 4 4 4 4 4 3 3 3 3 3 3 3 3 4 4 0 0 0 2 2 2 2 2 2 
2 2 3 3 3 3 3 3 3 3 3 2 2 2 2 2 1 1 1 1 1 1 4 4 4 1 1 3 3 3 3 3 3 3 3 3 3 4 4 0 0 0 0 2 2 2 2 2 2 2
2 2 3 3 3 3 3 3 3 3 3 3 2 2 2 2 0 1 0 0 0 0 1 1 1 1 1 1 1 1 3 3 3 3 3 3 3 4 4 4 4 2 2 2 2 2 2 2 2 2
2 2 3 3 3 3 3 3 3 3 3 2 2 2 2 2 0 1 0 0 0 0 0 0 0 0 0 0 0 1 1 0 3 3 3 3 4 4 4 4 2 2 2 2 2 2 2 2 2 2
2 2 3 3 3 3 3 3 3 3 2 2 2 2 2 2 0 1 0 0 0 0 0 0 0 0 0 10 11 0 0 0 1 1 1 4 4 4 4 4 2 2 2 2 2 2 2 2 2 2
2 2 3 3 3 3 3 3 3 2 2 2 2 2 2 0 1 1 0 0 0 6 7 0 0 0 0 12 13 0 0 0 0 0 1 4 4 4 4 2 2 2 2 2 2 2 2 2 2 2
2 2 2 3 3 3 3 2 2 2 2 2 2 2 0 1 1 0 0 0 0 8 9 0 0 0 0 0 0 0 0 0 26 0 1 4 4 4 4 2 2 2 2 2 2 2 2 2 2 2
2 2 2 2 2 2 2 2 2 2 2 2 2 0 0 1 0 0 26 0 0 0 0 0 0 27 0 0 0 0 0 0 0 0 1 1 4 4 4 2 2 2 2 2 2 2 2 2 2 2
2 2 2 2 2 2 2 2 2 2 2 2 0 0 0 1 0 0 0 0 0 0 0 0 0 0 0 0 0 0 0 0 0 1 1 0 0 2 2 2 2 2 2 2 2 2 2 2 2 2
2 2 2 2 2 2 2 2 2 2 2 2 0 0 0 1 1 1 1 1 1 1 1 1 1 1 1 1 1 1 1 1 1 1 0 0 2 2 2 2 2 2 2 2 2 2 2 2 2 2